#######################################
# Syntax Coloring Map For Totem Library
#######################################

#######################################
# Datatypes (KEYWORD1)
#######################################

Totem		KEYWORD1
TotemModule	KEYWORD1
ModuleData	KEYWORD1
MotorDriver	KEYWORD1
TotemVirtual	KEYWORD1
TotemRobot	KEYWORD1
LabBoard	KEYWORD1

#######################################
# Methods and Functions (KEYWORD2)
#######################################

# ModuleData
is	KEYWORD2
isInt	KEYWORD2
isString	KEYWORD2
getData	KEYWORD2
getCmdHash	KEYWORD2
# MotorDriver
setTurnIntensity	KEYWORD2
addFrontLeft	KEYWORD2
addFrontRight	KEYWORD2
addRearLeft	KEYWORD2
addRearRight	KEYWORD2
addServo	KEYWORD2
moveServo	KEYWORD2
brakeAll	KEYWORD2
brakeRear	KEYWORD2
brakeFront	KEYWORD2
setModule	KEYWORD2
getModule	KEYWORD2
# TotemModule
writeWait	KEYWORD2
readWait	KEYWORD2
subscribe	KEYWORD2
subscribeWait	KEYWORD2
unsubscribe	KEYWORD2
unsubscribeWait	KEYWORD2
attachOnData	KEYWORD2
setNumber	KEYWORD2
setSerial	KEYWORD2
hashCmd	KEYWORD2
hashModel	KEYWORD2
# TotemRobot
getName	KEYWORD2
getAddress	KEYWORD2
getModel	KEYWORD2
getColor	KEYWORD2
getNumber	KEYWORD2
isConnected	KEYWORD2
# Interface BLE
findRobot	KEYWORD2
findRobotNoBlock	KEYWORD2
isFinding	KEYWORD2
stopFind	KEYWORD2
attachOnConnect	KEYWORD2
getConnectedCount	KEYWORD2
getConnectedLast	KEYWORD2
getConnectedList	KEYWORD2
# Interface X4
beginNoBluetooth	KEYWORD2
# LabBoard
getVIN	KEYWORD2
get50V	KEYWORD2
get5V	KEYWORD2
get05V	KEYWORD2
getAmp	KEYWORD2
setVREG	KEYWORD2
setDAC1	KEYWORD2
setDAC2	KEYWORD2
setDAC3	KEYWORD2
getVREG	KEYWORD2
getDAC1	KEYWORD2
getDAC2	KEYWORD2
getDAC3	KEYWORD2
start	KEYWORD2
startBurst	KEYWORD2
setBurstCount	KEYWORD2
setFrequency	KEYWORD2
setDutyCycle	KEYWORD2
setPeriod	KEYWORD2
setPulseWidth	KEYWORD2
isBurst	KEYWORD2
isRunning	KEYWORD2
getFrequency	KEYWORD2
getDutyCycle	KEYWORD2
getPeriod	KEYWORD2
getPulseWidth	KEYWORD2
getCount	KEYWORD2
resetCount	KEYWORD2
setSampleEdge	KEYWORD2
getSampleEdge	KEYWORD2
getDIG1	KEYWORD2
getDIG2	KEYWORD2
setBlink	KEYWORD2
setBlinkBinary	KEYWORD2
setBrightness	KEYWORD2
setMonitor	KEYWORD2
on	KEYWORD2
off	KEYWORD2
set	KEYWORD2
setBinary	KEYWORD2
getBinary	KEYWORD2
runBoot	KEYWORD2
restart	KEYWORD2


#######################################
# Instances (KEYWORD2)
#######################################

#######################################
# Constants (LITERAL1)
#######################################

BLE	LITERAL1
X4	LITERAL1
LB	LITERAL1
KEY_MINUS	LITERAL1
KEY_PLUS	LITERAL1
KEY_RIGHT	LITERAL1
KEY_MIDDLE	LITERAL1
KEY_LEFT	LITERAL1
LED_ALL	LITERAL1
LED_DIG1	LITERAL1
LED_DIG2	LITERAL1
LED_50V	LITERAL1
LED_5V	LITERAL1
LED_05V	LITERAL1
LED_DAC1	LITERAL1
LED_DAC2	LITERAL1
LED_DAC3	LITERAL1
LED_VIN	LITERAL1
LED_VREG	LITERAL1
LED_mAmp	LITERAL1
